{
"DEBKGNU2000000AJ" : 1000,
"DEBKGNU2000000AK" : 2500,
"DEBKGNU2000000AL" : 2566,
"DEBKGNU2000000AM" : 4000,
"DEBKGNU2000000AN" : 3000,
"DEBKGNU2000000AO" : 3300,
"DEBKGNU2000000AP" : 6000,
"DEBKGNU2000000AQ" : 5500,
"DEBKGNU2000000AR" : 4400,
"DEBKGNU2000000AS" : 6500,
"DEBKGNU2000000AT" : 7000,
"DEBKGNU2000000AU" : 7500,
"DEBKGNU2000000AV" : 8000,
"DEBKGNU2000000AW" : 8500,
"DEBKGNU2000000AX" : 9000,
"DEBKGNU2000000AY" : 9500,
"DEBKGNU2000000AZ" : 1500,
"DEBKGNU2000000B0" : 1200,
"DEBKGNU2000000B1" : 1100,
"DEBKGNU2000000B2" : 2100,
"DEBKGNU2000000B3" : 2800,
"DEBKGNU2000000B4" : 3600,
"DEBKGNU2000000B5 : 3800"
}
